WE ./textures/west.xpm


C 225, 30 ,0


     F 8   ,   255, 222


EA ./textures/east.xpm

NO ./textures/north.xpm

SO ./textures/south.xpm

1111111111
1000000101
1000000001
1100000N01
1000000001
1000000001
1000000001
1000000001
1000000001
1111111111