111111111111
1E0000010001
10010C0000P1
100101000001
111111111111
