11111111
1E010001
10010101
10010101
11010101
100001P1
11111111
