11111111
1E000001
10010001
10010101
11011101
100001P1
11111111
