111111111111
1E0000010001
10010C0011P1
100101010001
111111111111
